#Parameters
400 30 2
SPEED / LEVELUP / POINTS
#Level Map
********
********
********
********
********
********
********
********
********
********
********
*******I
*******I
OO**SS*I
OO***SSI