#Parameters
300 0 3
SPEED / LEVELUP / POINTS
#Level Map
********
********
********
********
********
********
********
********
***OO***
***OO***
****IIII
*******I
*******I
*******I
*******I