#Parameters
300 0 5
SPEED / LEVELUP / POINTS
#Level Map
**********
**********
**********
**********
**********
**********
**********
**********
**********
**********
**********
**********
****I*****
***III****
***III****
***III****
***III****
***JIL****
OO*JIL*OO*
OOJJILLOO*