#Parameters
450 30 2
SPEED / LEVELUP / POINTS
#Level Map
**********
**********
**********
**********
**********
**********
**********
**********
**********
**********
**********
**********
**********
**********
**********
**********
*********I
**L******I
**LZZ**T*I
**LLZZTTTI